##################################################
#.#..OO.OO...O..OO..#.....O....#OO.#....#..OO....#
#O..O......O#...O.....#..OO..O....O...OO##O..O#..#
##.O.O...O.#.O...O#O...O.#O..#..#....#O.O.OOO...##
###...O...O.OO..OO....O.........OO..OO..#..O...#O#
#OOOOO...O.OO.O..OO.O.....O.O...OO..O#......O.O.##
#..#..#..##.OOO.#O..O....................O#.O..#.#
#.....O.O.O.OO..#.#.O...OOO.O.#.........O.#......#
#........#....O..O.OOO.OOO..O...O.O.OOO.O...O.O.O#
#..O..O........O..O#...O.O....#..O......O..O.#O..#
#O....O.O...O.........#...#.....OO....O......OOOO#
#..O.....OOO#O..O.O.#.............O.#OO....OO.O.O#
#...OO.....#....OO......O#..OOO....O.O..#OO......#
#....O#.......O....#.#.O..#.OO#O..O...OO..#O#O..O#
#..O..O.........O..#.OO.#O......OO.OO......O...#.#
#...............#...#.#...O#............O.......O#
#OO...O.OOOO#O.....O........OO.OOO.OO....OO#.#...#
#.O.#O..OO.OO..O..#..#..#..O...OOOO...........O#.#
#...OO......O...O..O...O.O.O#..OOO......O#..O....#
##..OO....OO.....#.O...O..OO.O.O..O##..O....#....#
#......O...O....#OO..#.OO.O.O.O.#.OO...O....OO.#.#
##.....#.OO.O.............#O......OOO#..........O#
#.........O...#OO.....#.....O..#.....OO.O.#O.....#
#.........#O...OO..O...#.OOO......O....O...O.O.#.#
#....O..#...OO.OOO......@..#..O.O..O.O.......#O.O#
#.OO.#O.O..#..O.......OO.....#.O.O...##O.......#.#
#..O....O.O.....#.O.OO..O...#OOO.O...OO.O..#.....#
#.#.O.OO.#...O.....#...O#.O..#O#O.OO............##
#....#.O....O..O...OO...........O.O.OO.O.OO..#.O.#
#O..O.O.O.OOO.O..O...#O.O..OOO.O#O...#.O...OO.O.O#
#OO....#.....O.O..#.#.O.O..........OO.#..O#......#
#..O......O#..O...##O.O..O.O.#...O.OO.O....O..O..#
#.#..O.O.....#O.O...OOOO....O#O.OO#....O......OOO#
##..#...OO###.O..O.OOO.O.O.........#..O..O.O..O..#
##...OOOOO.OOOO#..O##...O.....O.O..OO....OOO#....#
#....O.O..OO..#O..#...O........OOO.O.##.O.#.##..O#
#.....OO..OO..O...#.....O.......#..........O.#.#O#
##..#.....#.O...O#..O.....#.....#..#...OO....O...#
#.OO...O.OO..#O#...#...O.O.##..O..#O#.........O..#
#......O.O..O.OO.#.O.O..O...OOO....#.O.OO.O..O...#
#..#...O...O..OOO..............O.#...O..O....O.###
#........OOO...O..#.....OO...OO....O......#.OOO#O#
#.##.OO..O.....##.OO.OO.#.O.##..#..........OO....#
#..O.O..O.O.#.OOO...#....O..#..#.O.O....#.O..O..##
#O..O..O..O.O.............OOO.O..O..O..O..O.OO##.#
#...O#OO..OO...O.....O..#O.O...O...O.OO...OO.....#
#..O...#..#.O....#.....#.OOO#........O.....#.O...#
#.OO...OOOO.....#O......#.....O..O.O.O.#.........#
#.....O.O#.O..OO......O..O.O.O....##O#..O.#...#..#
##################################################
